Season,Spending (€M),Income (€M),Net Spend (€M),LaLiga Position,Champions League,Total Titles
2013/14,90,30,60,2,Quarter-finals,0
2014/15,81,35,46,1,Winners,3
2015/16,62,31,31,1,Quarter-finals,2
2016/17,122,34,88,2,Quarter-finals,1
2017/18,375,232,143,1,Quarter-finals,2
2018/19,130,125,5,1,Semi-finals,2
2019/20,155,137,18,2,Quarter-finals,0
2020/21,65,126,-61,3,Round of 16,0
2021/22,55,20,35,2,Group stage,0
2022/23,153,92,61,1,Round of 16,2
